21 23
11111111111111111111111
1A1   1           1 1 1
1 1 1 1 1111111 1 1 1 1
1 1 1 1       1 1 1 1 1
1 1 1 111111111 1 1 1 1
1 1 1 1       1 1   1 1
1 1 1 1 11111 1 11111 1
1 1 1 1     1 1 1   1 1
1 111 111 1 1 1 1 1 1 1
1     1   1 1 1 1 1 1 1
111 1111111 1 1 111 1 1
1     1       1   1 1 1
11111 1 11111 111 1   1
1   1     1     1 1 1 1
1 1 11111 111 1 1 1 1 1
1 1     1 1   1   1 1 1
1 11111 1 1 111 111   1
1 1   1 1 1   1 1   1 1
1 1 1 1 11111 1 1 1 1 1
1   1 1       1   1 1H1
11111111111111111111111